15 25 3 10 10 17
9 10 12 15 15 15 15 15 15 15 15 15 15 15 15 15 15 9 10 10 10 8 14 15 15 
5 15 1 10 8 10 8 10 8 10 12 9 10 10 10 10 10 6 15 15 15 3 10 10 12 
1 10 6 15 7 15 7 15 7 15 5 5 15 15 15 15 15 15 15 15 15 15 15 15 5 
5 15 15 15 15 15 15 15 15 15 7 5 15 15 15 15 15 15 15 15 15 15 15 15 5 
1 10 10 14 9 10 10 10 10 10 10 2 10 10 10 10 10 8 10 12 15 15 15 15 5 
5 15 15 15 5 15 15 15 15 15 15 15 15 15 15 15 15 7 15 7 15 15 15 15 5 
5 15 15 15 5 15 15 15 15 15 15 15 15 15 15 15 15 15 15 15 15 15 15 15 5 
5 15 15 15 5 15 15 15 9 10 10 12 15 15 15 9 10 10 10 10 10 10 12 15 5 
5 15 15 15 5 15 15 15 5 9 8 4 15 15 15 1 8 8 8 8 8 12 5 15 5 
5 15 15 15 5 15 15 15 5 3 6 5 15 15 15 5 1 0 0 0 0 4 5 15 5 
5 15 15 15 5 15 15 15 1 10 10 6 15 15 15 5 3 2 2 2 2 2 4 15 5 
5 9 8 14 5 15 15 15 5 15 15 15 15 15 15 1 10 10 10 10 10 10 6 15 5 
5 1 2 12 5 15 15 15 5 15 15 15 15 15 15 5 15 15 15 15 15 15 15 15 5 
5 3 14 3 2 10 10 10 0 10 10 10 10 10 10 0 14 15 15 15 15 15 15 15 5 
3 10 10 10 10 10 10 10 6 15 15 15 15 15 15 7 11 10 10 10 10 10 10 10 6 
