10 10 0 0 9 9
0 0 0 6 0 0 3 0 0 0
0 0 0 0 0 0 0 0 0 0
0 0 0 0 0 0 0 0 0 0
0 0 0 0 0 0 0 0 0 0
0 0 0 8 8 2 2 0 0 0
0 0 0 0 0 0 0 0 0 0
0 0 0 4 0 0 1 0 0 0
0 0 0 4 0 0 1 0 0 0
0 0 0 0 0 0 0 0 0 0
0 0 0 12 0 0 0 9 0 0