10 10 0 7 9 1
9 12 9 8 12 9 8 12 11 14 
5 1 0 0 0 0 0 2 8 14 
3 0 2 2 4 1 2 8 2 14 
9 4 9 8 0 0 10 0 8 14 
3 6 1 0 0 0 8 4 5 15 
11 8 0 0 0 2 0 6 7 13 
9 4 1 4 5 11 0 12 11 4 
1 0 2 0 2 8 0 0 14 5 
1 4 11 0 8 6 1 4 9 4 
3 2 10 2 6 11 6 3 2 6 
