10 10 0 8 9 9
11 10 8 8 8 8 10 12 11 12 
9 8 4 5 1 0 10 0 14 7 
1 0 2 4 5 1 12 5 15 13 
7 1 12 1 6 5 1 2 12 7 
15 1 0 0 8 0 0 10 2 14 
13 1 0 0 4 5 5 9 10 14 
3 0 2 4 3 0 2 0 8 14 
15 1 8 4 9 0 12 5 3 12 
15 1 0 2 4 1 0 0 10 4 
11 6 3 10 6 3 6 3 10 6 
