10 10 0 7 9 2
9 12 9 12 9 14 13 9 10 12 
3 6 1 0 0 8 4 7 9 4 
9 12 3 0 0 0 4 11 0 4 
1 4 15 1 6 1 6 15 1 4 
3 4 9 6 13 7 11 8 0 6 
9 6 3 12 7 15 11 0 0 12 
7 13 15 3 12 9 10 0 0 4 
11 4 11 12 1 0 10 2 4 5 
13 3 12 5 5 3 12 9 0 4 
3 10 6 3 2 10 2 2 2 6 
