10 10 0 0 9 9
15 15 15 15 15 15 15 15 15 15
11 14 15 15 15 15 15 15 11 14
15 15 15 15 15 15 15 15 15 15
15 15 15 15 15 15 15 15 15 15
15 15 15 15 15 15 15 15 15 15
11 10 14 15 15 15 15 15 15 15
15 15 15 15 15 15 15 15 15 15
11 14 15 15 15 15 15 15 15 15
11 14 15 15 15 15 15 15 11 14
15 15 15 15 15 15 15 15 15 15