10 10 0 6 9 9
9 10 8 8 12 9 8 8 14 13 
7 13 1 4 3 0 4 5 11 4 
9 0 0 0 8 0 0 0 12 5 
1 0 6 5 1 0 0 0 0 6 
1 0 8 4 1 0 2 0 2 14 
5 7 5 5 3 0 14 3 10 14 
7 9 0 0 12 1 14 9 14 13 
9 0 2 2 0 2 8 4 9 4 
1 0 8 10 0 14 7 3 2 4 
3 6 7 11 2 10 14 15 15 7 
