10 10 0 1 9 2
15 13 9 8 8 10 12 11 12 13 
11 4 1 0 0 12 1 12 1 4 
11 0 0 6 5 1 0 6 1 4 
9 2 4 11 0 2 0 8 0 6 
5 15 3 14 5 11 0 0 0 12 
1 10 10 8 0 14 3 0 2 4 
1 14 9 0 0 14 11 0 12 5 
1 8 2 4 3 12 13 5 3 4 
7 1 12 1 8 0 4 1 14 5 
15 3 6 3 6 3 2 6 11 6 
