10 10 0 1 9 6
9 8 12 9 8 10 12 9 10 14 
3 6 5 1 0 8 0 0 10 12 
11 8 4 1 6 3 0 0 8 4 
13 1 4 1 12 13 3 2 0 4 
5 1 0 0 4 5 13 9 4 7 
3 4 7 3 0 6 1 0 0 12 
9 2 10 10 0 12 7 3 0 4 
5 13 13 13 7 5 9 14 3 4 
1 4 3 4 15 3 0 10 8 4 
7 7 11 2 14 11 6 11 2 6 
