10 10 0 7 9 8
9 10 8 8 10 8 8 14 11 12 
5 9 0 2 12 1 2 10 10 4 
5 1 0 8 0 0 8 14 9 4 
1 2 2 0 0 0 4 13 1 4 
5 13 9 6 3 2 4 3 4 5 
1 0 2 12 11 10 0 10 0 4 
7 3 8 4 15 9 0 8 6 7 
13 9 0 6 11 2 0 0 8 12 
5 7 7 13 15 13 1 0 0 4 
7 11 10 2 14 3 2 6 3 6 
