10 10 0 8 9 2
9 8 8 8 12 9 12 13 15 13 
3 2 0 2 0 0 4 3 14 5 
13 9 0 10 0 0 0 12 11 6 
5 1 0 14 1 0 2 0 8 14 
1 2 0 8 0 0 10 0 0 12 
1 8 0 0 0 0 10 0 0 4 
5 5 1 2 0 6 9 0 0 4 
3 2 4 13 3 12 5 3 0 6 
15 13 1 2 8 0 0 10 0 14 
11 2 2 14 7 7 3 10 6 15 
