10 10 0 0 9 9
9 8 8 8 8 8 8 8 8 12
1 0 0 0 0 0 0 0 0 4
1 0 0 0 0 0 0 0 0 4
1 0 0 0 0 0 0 0 0 4
1 0 0 0 0 0 0 0 0 4
1 0 0 0 0 0 0 0 0 4
1 0 0 0 0 0 0 0 0 4
1 0 0 0 0 0 0 0 0 4
3 0 0 0 0 0 0 0 0 4
15 3 2 2 2 2 2 2 2 6