10 10 0 6 9 0
9 8 8 12 13 11 12 11 8 14 
1 4 7 3 2 14 3 12 1 14 
1 4 15 15 11 8 10 2 0 12 
5 1 8 14 9 0 10 10 0 6 
1 2 0 10 2 0 8 10 0 14 
5 9 0 8 8 0 0 12 3 14 
1 4 7 3 0 0 0 2 12 13 
1 4 9 10 2 0 0 8 2 6 
1 0 2 8 8 0 2 0 8 12 
7 7 11 6 7 3 10 2 2 6 
