10 20 0 0 9 9
9 8 10 14 13 11 8 14 15 15 11 10 12 11 8 12 11 12 9 14 
5 1 14 11 2 10 0 14 9 12 11 14 1 8 4 3 14 1 6 13 
7 5 9 12 13 9 0 10 0 0 10 12 3 0 2 8 8 4 15 7 
15 1 4 5 1 0 0 8 0 0 8 4 11 2 12 1 2 0 8 12 
9 0 0 0 6 5 1 0 0 2 0 0 8 8 0 0 8 6 1 4 
1 4 5 1 12 5 5 1 6 13 3 0 0 0 4 1 0 12 1 4 
1 0 0 2 2 0 0 0 8 0 8 4 3 0 0 0 4 7 7 5 
1 4 1 8 10 6 1 0 0 2 0 4 9 0 0 0 0 10 10 6 
1 0 4 1 14 9 0 2 0 14 1 0 0 2 0 0 4 9 8 12 
3 6 3 2 10 6 3 14 7 15 7 3 2 10 6 3 2 2 2 6 
