10 10 0 4 9 8
9 8 8 12 9 8 14 9 8 12 
1 0 0 2 0 0 8 2 0 4 
3 0 4 9 0 0 2 12 5 5 
9 4 3 0 2 4 13 3 0 4 
1 4 9 4 11 4 5 9 0 4 
1 0 2 4 11 0 2 6 1 4 
3 0 10 6 15 3 12 13 3 4 
13 3 14 9 10 8 2 4 15 5 
1 12 11 0 12 1 8 2 8 4 
3 2 10 2 2 2 2 10 6 7 
