10 10 0 5 9 9
11 10 8 8 8 12 9 8 8 12 
9 10 2 2 0 4 3 0 2 6 
1 10 8 8 4 3 8 2 8 12 
3 8 4 7 7 11 0 8 0 4 
13 1 6 13 13 13 1 0 0 4 
3 2 8 2 0 0 0 4 5 7 
11 12 1 8 0 0 0 6 1 14 
9 0 4 5 5 1 4 9 0 12 
1 0 0 6 1 0 2 6 3 6 
3 2 2 10 2 6 11 10 10 14 
