10 10 0 3 9 0
13 9 8 10 8 10 8 10 8 14 
1 0 0 10 4 9 2 14 5 15 
1 0 0 12 1 4 13 9 6 13 
1 4 5 1 4 3 0 0 8 4 
1 0 4 5 1 8 6 1 6 7 
3 2 0 0 0 0 8 0 10 12 
13 13 1 0 0 0 4 1 8 4 
5 1 0 4 3 4 1 2 0 4 
3 0 0 4 9 2 0 10 0 4 
11 2 2 2 6 15 7 11 2 6 
