10 10 0 5 9 6
9 12 15 13 15 9 8 12 9 12 
1 6 9 4 11 0 0 4 1 4 
1 8 0 4 11 0 0 4 5 7 
1 0 6 1 12 1 0 0 4 13 
7 1 10 0 4 3 2 4 5 5 
9 0 8 0 6 13 11 4 1 4 
1 0 0 4 13 1 12 3 0 4 
1 4 5 7 1 0 2 8 0 4 
1 2 0 10 6 1 8 2 6 7 
3 10 2 10 10 6 7 11 10 14 
