10 10 0 6 9 4
9 10 12 9 8 8 8 8 14 15 
1 12 1 6 3 4 1 0 12 13 
3 4 5 11 10 0 0 0 0 6 
13 5 1 8 12 1 0 2 0 14 
1 0 0 4 3 2 2 10 0 12 
1 2 4 1 10 10 12 9 2 4 
5 9 0 0 8 8 4 1 8 4 
1 0 0 0 0 0 4 1 0 6 
5 1 0 0 0 0 0 0 4 15 
7 3 2 2 6 3 2 2 2 14 
