10 10 0 2 9 7
13 11 10 12 11 10 8 12 9 12 
1 10 14 3 12 11 6 1 0 6 
7 11 10 12 3 8 8 0 2 12 
13 11 8 0 10 0 0 0 8 6 
1 14 3 6 11 0 4 1 0 12 
1 8 14 15 13 1 0 2 0 4 
1 4 11 8 4 1 0 14 3 6 
1 6 13 3 0 0 0 10 8 12 
5 13 3 10 0 0 0 14 1 4 
3 6 15 11 2 2 2 10 6 7 
