10 10 0 6 9 6
9 12 13 11 14 15 13 9 14 15 
3 0 4 9 8 8 2 6 15 15 
15 3 0 0 0 0 12 11 12 13 
9 8 0 0 0 2 0 12 7 5 
1 2 6 7 3 12 1 0 10 4 
7 13 15 9 8 0 2 0 8 4 
9 0 14 1 6 5 9 2 0 6 
3 4 11 0 10 0 4 13 1 12 
9 0 8 2 12 5 5 3 0 4 
3 6 3 10 6 3 2 10 2 6 
