10 10 0 0 9 4
13 13 13 9 8 8 8 8 8 12 
3 4 1 0 4 5 1 4 5 5 
13 1 0 2 6 7 3 2 0 4 
3 0 4 9 14 13 9 8 0 4 
9 0 4 1 10 0 2 0 0 6 
1 6 1 6 9 0 14 5 3 12 
1 10 0 12 1 6 9 4 11 6 
1 12 3 0 0 8 0 0 8 14 
5 7 9 0 0 2 2 2 2 14 
7 15 3 2 6 11 14 11 14 15 
