10 10 0 9 9 8
9 8 14 15 11 8 10 8 12 13 
1 0 10 8 8 0 8 6 1 4 
1 0 14 1 0 4 7 9 0 6 
5 5 11 2 4 1 14 1 4 13 
1 0 8 12 3 0 8 0 0 4 
3 0 6 1 8 2 0 4 3 4 
13 5 9 0 0 12 5 5 9 6 
3 0 0 2 4 3 2 0 0 12 
9 4 3 8 0 8 10 0 4 5 
3 2 10 2 2 2 10 2 2 6 
