10 10 0 3 9 5
13 13 11 8 8 8 10 10 10 14 
5 1 10 0 0 4 13 11 10 12 
3 0 8 0 0 0 4 15 11 4 
13 7 5 1 0 4 5 9 14 5 
3 10 0 0 2 0 0 0 8 6 
9 10 0 2 14 1 2 0 0 12 
3 10 0 8 12 1 8 0 0 4 
15 9 0 6 5 1 0 4 5 7 
9 0 0 8 0 0 0 2 4 13 
7 3 2 2 6 3 6 15 3 6 
