10 10 0 0 9 7
9 8 12 13 11 8 8 8 10 14 
1 2 2 0 8 0 0 0 12 15 
1 12 13 1 0 0 0 4 1 12 
1 0 4 7 1 0 0 0 6 7 
1 6 5 9 2 0 4 1 10 12 
1 12 1 0 10 6 1 6 15 5 
1 0 4 1 12 9 6 13 9 6 
1 4 3 2 4 1 10 2 4 15 
1 0 14 11 0 0 10 10 0 12 
7 3 10 14 3 2 10 14 3 6 
