10 20 0 4 9 5
13 13 9 8 10 8 10 12 13 13 11 8 8 14 13 9 8 12 13 15 
7 1 0 6 13 1 10 2 6 1 14 1 2 14 3 0 6 5 5 13 
13 3 0 10 0 4 13 15 13 5 9 0 12 13 9 4 11 0 0 4 
1 8 0 12 1 4 3 8 0 0 4 3 0 0 0 4 9 0 0 4 
1 0 6 7 3 0 8 0 0 6 1 8 6 3 4 1 2 2 6 5 
5 5 15 9 8 0 4 7 1 10 2 0 14 9 0 0 8 10 10 4 
1 0 12 5 7 7 3 8 4 13 9 0 8 0 2 0 4 13 13 5 
1 2 4 7 13 11 10 0 0 0 2 6 1 0 8 0 0 4 1 4 
5 11 4 11 6 9 12 1 0 0 12 11 2 0 0 0 0 2 4 5 
3 10 2 10 10 2 2 2 2 2 2 10 10 2 2 2 2 10 6 7 
