5 10 0 5 4 3
13 11 8 8 8 10 10 8 12 13 
5 9 2 4 5 11 12 5 3 4 
1 0 8 4 3 8 0 0 8 6 
7 1 0 0 10 4 1 0 0 12 
15 7 3 2 14 7 3 2 6 7 
